...................
...................
....g..g.ggggggg...
g.....g.gggggg.##..
......##.g#r####...
......###.r#.r.....
.....S.Wr..........
...................
..........rw.s.....
.....r.#r.###......
...####r#g.##......
..##.gggggg.g.....g
...ggggggg.g..g....
...................
...................
