...................
...................
............ggg....
#######.....##g....
....g#.......#g....
...................
...........W.......
...................
...................
...................
....g#...S...#g....
....g##..r..#######
....ggg........s...
..........w........
...................