...................
.W.S...............
............ggg....
#######..r..##g....
....g#...g...#g....
.........g.........
.........g.........
.....rgggggggr.....
.........g.........
.........g.........
....g#...g...#g....
....g##..r..#######
....ggg............
...............s.w.
...................