...................
...................
..#...W.........#..
...#Sg#..r..#g.#...
..g.g.g.....g.g.g..
...g.g.......g.g...
....gg.......gg....
...................
....gg.......gg....
...g.g.......g.g...
..g.g.g.....g.g.g..
...#.g#..r..#gs#...
..#.........w...#..
...................
...................
